######################
#....................#
#..####..#####...#####
#..####....#.........#
#..####..#####...#####
#..####..............#
#..####..#####...#####
#....................#
######################