 
 ######################################################################################################################
 #....................................................................................................................#
 #..####..#####...#######.#.########..#######..##############..##.###########.##########.###################.########.#
 #..####....#.............#.########..#######..##############..##.###########.##########.###################.########.#
 #..####..#####...#######.#.########..#######..................##.###########.##########.###################.########.#
 #..####..................#.........................##.#######.##.###########.##########.###################.########.#
 #..####..#####...#########.########..############..##.#######.##.....................................................#
 #................#########.########..################.........##.###########.##########.##########.#################.#
 ###############..#########.########..################.##########.###########.##########.##########.#################.#
 #............................................................................##########.##########.#################.#
 #..####..#####...########..#####..#########..#######..####..###..###########.........................................#
 #..####....#..........###..##................#######..####..###..###########.#############.##############.##########.#
 #..####..#####...########..##..###..#######...........####..###..###########.#############.##############.##########.#
 #..####..............#..#..##..###..#######..#############..###..............#############.##############............#
 #..####..#####...#####..#........................................###########.#############.##############.####.#####.#
 #....................####..#######..#######..##..##############..###########....................#########.####.#####.#
 ###.#######.#######.#####..#..............#..##..#########...........#######.##################.#########.####.#####.#
 #....................####..#..####..####..#..##.............###..###########.##################.#########.####.#####.#
 #..####..#####...########..#..####..####..#..##################..###########.##################.#########.####.#####.#
 #..####....#.........####..#..............#......................###########....................#########............#
 #..####..#####...########..###..#####..####..##################..###########.########.#########.#########.##########.#
 #..####..............####..#..............#..##################..............########.#########.#########.##########.#
 #..####..#####...########..################..##################..###########.########.#########......................#
 #................................................................###########.########.###################.##########.#
 #.#######..##############..####################################..###########..........###################.##########.#
 #.#######..##############..####################################..###########.############################.##########.#
 #....................................................................................................................#
 ######################################################################################################################
 