 
 ####################################################
 #..................................................#
 #.#.##.#######.#.#######.#.########.########.#.###.#
 #.#....#.......#.........#.#........#........#.###.#
 #.######.###############.#.#.######.#.########.###.#
 #..............#.........#.#........#..............#
 #.#.####.#####.#.#########.#.######.#.########.###.#
 #.#....#.......#.#.........#........#........#.###.#
 #.####.#.#######.#.#######.#######.######.####.###.#
 #..................................................#
 ####################################################
 